###########
#o  A#B  G#
# ##   ## #
# # o#o   #
# # ### # #
#S   o   o#
###########
